32
10 29 0 
29 10 0 
40 20 26 7 0 2 16 27 4 5 34 32 
20 40 32 34 5 4 27 16 2 0 7 26 
18 9 0 
9 18 0 
5 1 0 
1 5 0 
10 22 15 14 
22 10 14 15 
23 33 0 
33 23 0 
33 28 30 31 37 35 
28 33 35 37 31 30 
11 4 8 0 2 16 18 19 9 
4 11 9 19 18 16 2 0 8 
41 14 25 24 6 5 34 23 
14 41 23 34 5 6 24 25 
32 40 10 12 21 6 4 27 16 2 0 7 26 
40 32 26 7 0 2 16 27 4 6 21 12 10 
41 33 0 
33 41 0 
1 40 0 
40 1 0 
11 10 0 
10 11 0 
9 40 0 
40 9 0 
10 33 15 13 36 31 30 
33 10 30 31 36 13 15 
10 9 15 13 36 37 17 
9 10 17 37 36 13 15 
