110
1 2 4 5 9 19 
2 1 19 9 5 4 
1 3 4 5 9 20 
3 1 20 9 5 4 
1 4 4 5 9 16 18 
4 1 18 16 9 5 4 
1 5 4 5 9 16 17 
5 1 17 16 9 5 4 
1 6 4 5 10 15 13 
6 1 13 15 10 5 4 
1 7 4 5 10 11 22 
7 1 22 11 10 5 4 
1 8 4 5 8 0 
8 1 0 8 5 4 
1 9 4 3 21 6 
9 1 6 21 3 4 
1 10 4 3 2 
10 1 2 3 4 
1 11 4 3 1 
11 1 1 3 4 
2 3 19 20 
3 2 20 19 
2 4 19 16 18 
4 2 18 16 19 
2 5 19 16 17 
5 2 17 16 19 
2 6 19 16 14 13 
6 2 13 14 16 19 
2 7 19 16 14 12 22 
7 2 22 12 14 16 19 
2 8 19 9 8 0 
8 2 0 8 9 19 
2 9 19 9 8 7 6 
9 2 6 7 8 9 19 
2 10 19 9 5 3 2 
10 2 2 3 5 9 19 
2 11 19 9 5 3 1 
11 2 1 3 5 9 19 
3 4 20 16 18 
4 3 18 16 20 
3 5 20 16 17 
5 3 17 16 20 
3 6 20 16 14 13 
6 3 13 14 16 20 
3 7 20 16 14 12 22 
7 3 22 12 14 16 20 
3 8 20 9 8 0 
8 3 0 8 9 20 
3 9 20 9 8 7 6 
9 3 6 7 8 9 20 
3 10 20 9 5 3 2 
10 3 2 3 5 9 20 
3 11 20 9 5 3 1 
11 3 1 3 5 9 20 
4 5 18 17 
5 4 17 18 
4 6 18 14 13 
6 4 13 14 18 
4 7 18 14 12 22 
7 4 22 12 14 18 
4 8 18 16 9 8 0 
8 4 0 8 9 16 18 
4 9 18 16 9 8 7 6 
9 4 6 7 8 9 16 18 
4 10 18 16 9 5 3 2 
10 4 2 3 5 9 16 18 
4 11 18 16 9 5 3 1 
11 4 1 3 5 9 16 18 
5 6 17 14 13 
6 5 13 14 17 
5 7 17 14 12 22 
7 5 22 12 14 17 
5 8 17 16 9 8 0 
8 5 0 8 9 16 17 
5 9 17 16 9 8 7 6 
9 5 6 7 8 9 16 17 
5 10 17 16 9 5 3 2 
10 5 2 3 5 9 16 17 
5 11 17 16 9 5 3 1 
11 5 1 3 5 9 16 17 
6 7 13 12 22 
7 6 22 12 13 
6 8 13 15 10 8 0 
8 6 0 8 10 15 13 
6 9 13 15 10 8 7 6 
9 6 6 7 8 10 15 13 
6 10 13 15 10 5 3 2 
10 6 2 3 5 10 15 13 
6 11 13 15 10 5 3 1 
11 6 1 3 5 10 15 13 
7 8 22 11 10 8 0 
8 7 0 8 10 11 22 
7 9 22 11 10 8 7 6 
9 7 6 7 8 10 11 22 
7 10 22 11 10 5 3 2 
10 7 2 3 5 10 11 22 
7 11 22 11 10 5 3 1 
11 7 1 3 5 10 11 22 
8 9 0 7 6 
9 8 6 7 0 
8 10 0 7 21 2 
10 8 2 21 7 0 
8 11 0 7 21 1 
11 8 1 21 7 0 
9 10 6 21 2 
10 9 2 21 6 
9 11 6 21 1 
11 9 1 21 6 
10 11 2 1 
11 10 1 2 
